1111111111111111
1111111111111111
1111111111111111
1111111111111111
1000000PE00000C1
1111111111111111
1111111111111111
1111111111111111
1111111111111111