1111111111111111
1111111111111111
1111111111111111
1111111111111111
1000000PC0E00001
1111111111111111
1111111111111111
1111111111111111
1111111111111111