1111111
1PEC101
1111111
1111111
