1111111
1PEC001
11
1111111
1111111