1111111
1PEC001
1111111
1111111