1111111
111C111
1110111
1110111
111E111
111P111
1111111
1111111