1111111111111111
1111111111111111
1111111111111111
1111111111111111
1000000PC00E0001
1111111111111111
1111111111111111
1111111111111111
1111111111111111