11111111111111111111111111111
1P000000000011100000000000001
11110111111010101111111111101
10000100000010100000000010101
10111101111010111110111010101
10100001000010000010001010101
10101111011111111011101010101
10100000010000001000001010101
10111111010111101111111010101
10000001010100000000000010101
10111101010101111101111110101
101000C100000100000C1000000E1
10101111111111111111111111111
11111111111111111111111111111