11111111111111111111
10000000000000000001
10000000000000000001
1000000000000C000001
100000E0000000000001
10000000000000000001
10000000P00000000001
10000000000000000001
10000000000000000001
10000000000000000001
1000C000000C00000001
10000000000000000001
10000000000000000001
11111111111111111111